110120101112012000111201201000
011100101000010010100001001110
000111111110110110111011001010
011101000011100100001010011010
010001010000001100001111110010
010211011111111001111000000110
010000010000000011000011110100
011111111111111110011110010000
001000000000000000110000011110
011011111011111111100211000010
010010001010000100000001111010
010010111011010101111100001110
011010100001010101000100000000
001010120111010101011111111110
001010000100010101010000000010
011010011100110101010001112010
010010010000100101010001000010
011111011111100101010001111110
000001010000000101011100000000
011101010111111101000101111110
010101010100000001100101000010
010101010111111000100101010010
010111010000001110110101011110
010000011111100010010101000010
011110110000100011110101000010
000010100000100000010101000010
011110102110111111010111011111
010000100010100001010000011111
011111111110102111011111011111
000000000000000000000000011112
